16 16
###  ###
#  #  #      ###
  ## ##         #
# #   ##      ##
# # ####
  #
# #    #
#    ###


   ##
     ##
      ##
  ##
    #########
             ####