16 8
###  ###
#  #  #      ###
  ## ##       #
# #   ##      ##
# # ####
  #
# #    #
#    ###