8 8
###  ###
#  #  # 
  ## ## 
# #   ##
# # ####
  #     
# #    #
#    ###